{
    "calles": 10,
    "carreras": 10,
    "sentidos": [
      [1, 1, 1, 1, 1, 1, 1, 1, 1, 1],
      [1, 1, 1, 1, 1, 1, 1, 1, 1, 1],
      [1, 1, 1, 1, 1, 1, 1, 1, 1, 1],
      [1, 1, 1, 1, 1, 1, 1, 1, 1, 1],
      [1, 1, 1, 1, 1, 1, 1, 1, 1, 1],
      [1, 1, 1, 1, 1, 1, 1, 1, 1, 1],
      [1, 1, 1, 1, 1, 1, 1, 1, 1, 1],
      [1, 1, 1, 1, 1, 1, 1, 1, 1, 1],
      [1, 1, 1, 1, 1, 1, 1, 1, 1, 1],
      [1, 1, 1, 1, 1, 1, 1, 1, 1, 1]
    ],
    "semaforos": [
      [0, 1, 0, 1, 0, 1, 0, 1, 0, 1],
      [1, 0, 1, 0, 1, 0, 1, 0, 1, 0],
      [0, 1, 0, 1, 0, 1, 0, 1, 0, 1],
      [1, 0, 1, 0, 1, 0, 1, 0, 1, 0],
      [0, 1, 0, 1, 0, 1, 0, 1, 0, 1],
      [1, 0, 1, 0, 1, 0, 1, 0, 1, 0],
      [0, 1, 0, 1, 0, 1, 0, 1, 0, 1],
      [1, 0, 1, 0, 1, 0, 1, 0, 1, 0],
      [0, 1, 0, 1, 0, 1, 0, 1, 0, 1],
      [1, 0, 1, 0, 1, 0, 1, 0, 1, 0]
    ],
    "duracion_semaforos": 30,
    "puntos_interes": [
      {"nombre": "Museo", "calle": 2, "carrera": 3},
      {"nombre": "Parque", "calle": 7, "carrera": 8}
    ]
  }